#;#;#;#;#;#;#;#;#;#;#;#;#;#;#;#;#;#;#;#;#;#;#;#;#;#;#;#;#;#;#;#;#;#;#;#;#;#;#;#;#;#;#;#;#;#;#;#;#;#;#;#;#;#;#;#;#;#;#;#;#;#;#;#;
#;.;.;.;.;.;.;.;.;.;.;.;.;.;.;.;.;.;.;.;.;.;.;#;.;.;#;.;.;.;.;.;.;.;.;#;.;.;.;.;.;.;.;.;.;.;.;.;.;.;.;.;.;.;.;.;.;.;.;.;.;.;.;#;
#;.;.;.;.;.;.;.;.;.;.;.;.;.;.;.;.;.;.;.;.;.;.;#;.;.;#;.;.;.;.;.;.;.;#;#;.;.;.;.;.;.;.;.;.;.;.;.;.;.;.;.;.;.;.;.;.;.;.;.;.;.;.;#;
#;.;.;.;.;.;.;.;.;.;.;.;.;.;.;.;.;.;.;.;.;.;.;#;.;.;#;.;.;.;.;.;.;.;#;.;.;.;.;.;.;.;.;.;.;.;.;.;.;.;.;.;.;.;.;.;.;.;.;.;.;.;.;#;
#;.;.;.;.;.;.;.;.;.;.;.;.;.;.;.;.;.;.;.;.;.;.;#;.;.;#;.;.;.;.;.;.;#;#;.;.;.;.;.;.;.;.;.;.;.;.;.;.;.;.;.;.;.;.;.;.;.;.;.;.;.;.;#;
#;.;.;.;.;.;.;.;.;.;.;.;.;.;.;.;.;.;.;.;.;.;.;#;.;.;#;.;.;.;.;.;.;#;.;.;.;.;.;.;.;.;.;.;.;.;.;.;.;.;.;.;.;.;.;.;.;.;.;.;.;.;.;#;
#;.;.;.;.;.;.;.;.;.;.;.;.;.;.;.;.;.;.;.;.;.;.;#;.;.;#;.;.;.;.;.;#;#;.;.;.;.;.;.;.;.;.;.;.;.;.;.;.;.;.;.;.;.;.;.;.;.;.;.;.;.;.;#;
#;.;.;.;.;.;.;.;.;.;.;.;.;.;.;.;.;.;.;.;.;.;.;#;#;#;#;#;#;#;#;#;#;.;.;.;.;.;.;.;.;.;.;.;.;.;.;.;.;.;.;.;.;.;.;.;.;%;.;.;.;.;.;#;
#;.;.;.;.;.;.;.;.;.;.;.;.;.;.;.;.;.;.;.;.;.;.;#;.;.;.;.;.;.;.;.;.;.;.;.;.;.;.;.;<;.;.;.;.;.;.;.;.;.;.;.;.;.;.;.;.;.;.;.;.;.;.;#;
#;.;.;.;.;.;.;.;.;.;.;.;.;.;.;.;.;.;.;.;.;.;.;#;.;.;.;.;.;.;.;.;.;.;.;.;.;.;.;.;.;.;.;.;.;.;.;.;.;.;.;.;.;.;.;.;.;.;.;.;.;.;.;#;
#;.;.;.;.;.;.;.;.;.;.;.;.;.;.;.;.;.;.;.;.;.;.;#;.;.;#;#;#;#;#;#;#;.;.;%;.;.;.;.;.;.;.;.;.;.;.;.;.;.;.;.;.;.;.;.;.;.;.;.;.;.;.;#;
#;.;.;.;.;.;.;.;.;.;.;.;.;.;.;.;.;.;.;.;.;.;.;#;.;.;#;.;.;.;.;.;#;.;.;.;.;.;.;.;.;.;.;.;.;.;.;.;.;.;.;.;.;.;.;.;.;.;.;.;.;.;.;#;
#;.;.;.;.;.;.;.;.;.;.;.;.;.;.;.;.;.;.;.;.;.;.;#;.;.;#;.;.;.;.;.;#;.;.;.;.;.;.;.;.;.;.;.;.;.;.;.;.;.;.;.;.;.;.;.;.;.;.;.;.;.;.;#;
#;.;.;.;.;.;.;.;.;#;#;#;.;.;.;.;.;.;.;.;.;.;.;#;.;.;#;.;.;.;.;.;#;.;.;.;.;.;.;.;.;.;.;.;.;.;.;.;.;.;.;.;.;.;.;.;.;.;.;.;.;.;.;#;
#;.;.;.;.;.;.;.;.;#;>;#;.;.;.;.;.;.;.;.;.;.;.;#;.;.;#;.;.;.;.;.;#;.;.;.;.;.;.;.;.;.;.;.;.;.;.;.;.;.;.;.;.;.;.;.;.;.;.;.;.;.;.;#;
#;.;.;.;.;.;.;.;.;#;.;#;.;.;.;.;.;.;.;.;.;.;.;#;.;.;#;.;.;.;.;.;#;.;.;.;.;.;.;.;.;.;.;.;.;.;.;.;.;.;.;.;.;.;.;.;.;.;.;.;.;.;.;#;
#;.;.;.;.;.;.;.;.;#;.;#;#;#;#;#;#;#;#;#;#;.;.;#;.;.;#;.;.;.;.;.;#;.;.;.;.;.;.;.;.;.;.;.;.;.;.;.;.;.;.;.;.;.;.;.;.;.;.;.;.;.;.;#;
#;.;.;.;.;.;.;.;.;#;.;.;.;.;.;.;.;.;.;.;#;.;.;#;.;.;#;.;.;.;.;.;#;.;.;.;.;.;.;.;.;.;.;.;.;.;.;.;.;.;.;.;.;.;.;.;.;.;.;.;.;.;.;#;
#;.;.;.;.;.;.;.;.;#;#;#;#;#;#;#;#;#;#;.;#;#;.;#;.;.;#;.;.;.;.;.;#;.;.;.;.;.;.;.;.;.;.;.;.;.;.;.;.;.;.;.;.;.;.;.;.;.;.;.;.;.;.;#;
#;.;.;.;.;.;.;.;.;.;.;.;.;.;.;.;.;.;#;.;.;#;.;#;.;.;#;.;.;.;.;.;#;.;.;.;.;.;.;.;.;.;.;.;.;.;.;.;.;.;.;.;.;.;.;.;.;.;.;.;.;.;.;#;
#;.;.;.;.;.;.;.;.;.;.;.;.;.;.;.;#;#;#;#;.;#;#;#;.;.;#;.;.;.;.;.;#;.;.;.;.;.;.;.;.;.;.;.;.;.;.;.;.;.;.;.;.;.;.;.;.;.;.;.;.;.;.;#;
#;.;.;.;.;.;.;.;.;.;.;.;.;.;.;.;#;.;.;.;.;.;.;.;.;.;#;.;.;.;.;.;#;#;.;.;.;.;.;.;.;.;.;.;.;.;.;.;.;%;.;.;.;.;.;.;.;.;.;.;.;.;.;#;
#;.;.;.;.;.;.;.;.;.;.;.;.;.;.;.;#;.;.;.;.;.;.;.;.;.;#;.;.;.;.;.;.;#;.;.;.;.;.;.;.;.;.;.;.;.;.;.;.;.;.;.;.;.;.;.;.;.;.;.;.;.;.;#;
#;.;.;.;.;.;.;.;.;.;.;.;.;.;.;.;#;.;.;.;.;.;.;.;.;.;#;.;.;.;.;.;#;#;.;.;.;.;.;.;.;.;.;.;.;.;.;.;.;.;.;.;.;.;.;.;.;.;.;.;.;.;.;#;
#;.;.;.;.;.;.;.;.;.;.;.;.;.;.;.;#;.;.;.;.;.;.;.;.;.;#;.;.;.;.;#;#;.;.;.;.;.;.;.;.;.;.;.;.;.;.;.;.;.;.;.;.;.;.;.;.;.;.;.;.;.;.;#;
#;.;.;.;.;.;.;.;.;.;.;.;.;.;.;.;#;.;S;.;.;.;.;D;.;.;#;.;.;.;#;#;.;.;.;.;.;.;.;.;.;.;.;.;.;.;.;.;.;.;.;.;.;.;.;.;.;.;.;.;.;.;.;#;
#;.;.;.;.;.;.;.;.;.;.;.;.;.;.;.;#;.;a;.;.;%;.;.;.;.;#;.;.;#;#;.;.;.;.;.;.;.;.;.;.;.;.;.;.;.;.;.;.;.;.;.;.;.;.;.;.;.;.;.;.;.;.;#;
#;.;.;.;.;.;.;.;.;.;.;.;.;.;.;.;#;.;.;.;.;.;.;.;.;.;#;.;#;#;.;.;.;.;.;.;.;.;.;.;.;.;.;.;.;.;.;.;.;.;.;.;.;.;.;.;.;.;.;.;.;.;.;#;
#;.;.;.;.;.;.;.;.;.;.;.;.;.;.;.;#;#;#;#;#;#;#;#;#;#;#;#;#;.;.;.;.;.;.;.;.;.;.;.;.;.;.;.;.;.;.;.;.;.;.;.;.;.;.;.;.;.;.;.;.;.;.;#;
#;.;.;.;.;.;.;.;.;.;.;.;.;.;.;.;.;.;.;.;.;.;.;.;.;.;#;#;.;.;.;.;.;.;.;.;.;.;.;.;.;.;.;.;.;.;.;.;.;.;.;.;.;.;.;.;.;.;.;.;.;.;.;#;
#;.;.;.;.;.;.;.;.;.;.;.;.;.;.;.;.;.;.;.;.;.;.;.;.;.;#;.;.;.;.;.;.;.;.;.;.;.;.;.;.;.;.;.;.;.;.;.;.;.;.;.;.;.;.;.;.;.;.;.;.;.;.;#;
#;#;#;#;#;#;#;#;#;#;#;#;#;#;#;#;#;#;#;#;#;#;#;#;#;#;#;#;#;#;#;#;#;#;#;#;#;#;#;#;#;#;#;#;#;#;#;#;#;#;#;#;#;#;#;#;#;#;#;#;#;#;#;#;
